15
15
##############################..##############################
##......................##..........##..........##..........##
##################..######..######..##..##..##########..######
##..................##......##..##..##..##..........##......##
##..##################..######..######..##########..######..##
##..................##..##..##..........##..........##......##
##..##############..##..##..##############..######..##..######
##......##......##..##..##..........##......##......##......##
######..######..##..##..##########..##..##################..##
##..##..##......##..##..............##..........##......##..##
##..##..##..######..##########..######..######..##..##..##..##
##..........##......##..................##......##..##......##
######..######..##..##..................##..######..######..##
##..##..##......##......................##..##......##......##
##..##########..######..................##..##..##########..##
##......##..........##..................##..............##..##
##..##..##############..................######..######..##..##
##..##..##..........##......................##..##......##..##
##..##..##########..##..................##..######..######..##
##..##..........##......................##......##..##......##
##..######..##..##..##################..##..######..##..######
##......##..##..##......##..........##..##......##..##......##
######..##..##########..##..######..##..##..##..##########..##
##......##..............##..##..##......##..##..##..##......##
##..######..##############..##..######..##..##..##..##..######
##..##..##..##..........##..........##..##..##..##..##..##..##
##..##..##########..######################..######..##..##..##
##......##......##..##......................##..........##..##
##..##..##..##..##..##..######..##############..##########..##
##..##......##..##..........##......##......................##
##############################################################