11
11
##############################################
##..##..........##......//......##..........##
##..##..######..##..##########..##..######..##
##..##..##..##..........##......##..##......##
##..##..##..##//##########..##########..######
##......##..............//......##..........##
##..##########//##############..##..######..##
##......##..//......##......//..##..##......##
##########..##..######//######..######..######
##..##......##..##..........##......##......##
##..######..##..##..........##########..##..##
##..##......##..//..........//......##..##..//
##..##..##..######..........######..##..##..##
##..##..##..##..##..........##..##..##..##..##
##..##########..######//######..##..######..##
##..............................##..##......##
##############################..######..##//##
##......##..........##..........##......##..##
##..##..##..######..##..##########..######..##
##..##......##..............//......##......##
##..##########..######..##..##########..##..##
##......##......##......##..............##..##
##############################################